SO ./textures/redbrick.xpm

WE ./textures/mossy.xpm

EA ./textures/eagle.xpm

NO ./textures/wood.xpm

F 100,100,100
C 65,107,208
11111
10001
10N01
10001
11111
