R 1920 1080

NO ./textures/redbrick.xpm
SO ./textures/eagle.xpm
EA ./textures/mossy.xpm
WE ./textures/wood.xpm

C 204,255,255
F 102,51,0

111111111111111111111111111
100000000000000000000000001
10000110000011100000000W001
100001100000000000000000001
100000000000000011100000001
100001111100000000000000001
100000000110000000000000001
100000000000000000000000001
100000000000001110000000001
111111111111111111111111111
