R 960 540

NO ./textures/mossy.xpm
SO ./textures/eagle.xpm
EA ./textures/wood.xpm
WE ./textures/redbrick.xpm

F 255,0,0
C 0,0,255

        1111111111111111111111111
        1000000000110000000000001
        1011000001110000000000001
        1001000000000000000000001
111111111011000001110000000000001
100000000011000001110111111111111
11110111111111011100000010001
11110111111111011101010010001
11000000110101011100000010001
10000000000000001100000010001
10000000000000001101010000001
11000001110101011100011110N01111
11110111 11101011101111000001
11111111 111111111111 1111111
